.........
.RRRRRRR.
.RWWWWWR.
.RWWWWWR.
.RWWWWWR.
.RWWWWWR.
.RWWWWWR.
.PRRRRRR.
.........
