.........
.WWWWWWW.
.WRWWWRW.
.WWWWWWW.
.WWWPWWW.
.WWWWWWW.
.WRWWWRW.
.WWWWWWW.
.........
