.........
.WWWWWWW.
.WRWWWRW.
.WWWWWWW.
.W.WPW.W.
.WWWWWWW.
.WRWWWRW.
.WWWWWWW.
.........
