.........
.WWWWWWW.
.WWWWWWW.
.WWWWWWW.
.WWWWWWW.
.WWWWWWW.
.WP...RW.
.WWWWWWW.
.........
