.........
.WRGBYRW.
.BBYRGBB.
.WYBWWGY.
.WRWBYWW.
.WRWRBWB.
.GGYRYBW.
.PGWRRBW.
.........
