.........
.WWWWWWR.
.WWW.W.W.
.WW.WW.W.
.WWWW.WW.
...W.WWW.
.WWW.WWW.
.P.WWWWW.
.........
