.........
.WWWWWWW.
.WWWWWWW.
.WWWWWWW.
.WWWWWWW.
.WWWWWWW.
.WWWWWWW.
.PWWWWWW.
.........
